NO assets/textures/gre_wat.xpm
SO assets/textures/mir_wat.xpm
WE assets/textures/mush.xpm
EA assets/textures/silv_wat.xpm

F 220,100,0
C 225,30,0

     1
    111
   11011
  1100011          1            1
11111111111       111          111
11000000011      11011        11011
11000000011     11111111     1111111
111111111111  1101 101111     11 11
11111111111111111111111111111111111
11000000011   11000000011 101 11011
11000000011   11000000011 101 11011
11000000011111110000000111111110111
1100010001000001000100001     11011
110011100100S001001110001 111 11011
1100111001000001001110001 101 11011
1100111001000001001110001 111 11011
1100111001000001001110001     11011
11111111111111111111111111111111111